1111111111111111
1111100000000011
1111100000000011
1111100000000011
1111100000000011
1111111110011111