1111111111111111
1000001110001111
1000001000001111
1000000000000001
1000001000001101
1000001100111101
1000001100011101
1100011000001101
1100011000000001
1100011000001101
1100011100011101
1110110111111101
1110110000000001
1110000111111111
1111111111111111