1111111111111111111
1111111111111100001
1111111111111100001
1000001000001100001
1000000000001111101
1000000000000000101
1000001000000000101
1000001111111100101
1000001100011100101
1100011000001100101
1100011000000000101
1100011000001100101
1100011100011100101
1110111111111100101
1110110000000000001
1110000110000000001
1111111110111111111